R 1920 4515

NO ./a.xpm
SO ./b.xpm
WE ./c.xpm
EA ./d.xpm
S ./t.xpm


F 220,100,255
C 225,30,0


                1111111111
                1000000001
                10000E0001
                1000000001
11111111111111111000000001
11111100000000000000000001
     100000000000000000001
11111100000000000000000001
11111100000000000000000001
    1111100001111111111111
        100001
11111111111000111111111111
10000000000000000000000001
100000000000000000000000011
10000000000000000000000001
10000000000000000000000001
10000000000000000000000001
1111111111111111111111111111
11111111 1111111 11111111111