R 4000  4000

NO ./txt64-1.xpm
SO ./txt.64     4.xpm
WE ./txt64-1.xpm
EA ./txt64-1.xpm
S ./mario.xpm
F  48,14,28

C  48,14,28


                                          111
                                         10001
            11111111111111111111          101           11111111111111111111           
        111100000000000000000000111111111110111111111111000000000000000000001111     
    1111000000000000000000000000000000000000000000000000000000000S000000000000001111                
        111100000000000000000000111111111100011111111111000000000000000000001111               
            11111111202111111111          101           11111111202111111111           
                    101                   101                   101
                    101                   101                   101
                    101                   101                   101
                 111202111                101                111202111   
                10000000001               101               10000000001   
                 111202111                101                111202111   
                    101                   101                   101
                    101                   101                   101
                    101                   101                   101
                    10011111111111111111112021111111111111111111001                   
                    10000000000000000000000000000000000000000000001                   
                     111111111111111111111101111111111111111111111
                                          101
                                          101
                                          101
                                          101
                                         12021
                                        1000001
                                         11011
                                          101
                                           1




















