
R 1000 2000
NO ./txt64-4.xpm
SO ./txt64-1.xpm
WE ./txt64-2.xpm
EA ./txt64-3.xpm
S ./t.xpm
F  48,14,28
C  115,194,251
                                          111
                                         10001
            11111111111111111111          101           11111111111111111111           
        111130000000000000000003111111111110111111111111300000000000000000031111               
    111100000000000000000000000040000000000S0000000000040000000000000000000000001111                
        111130000000000000000003111111111130311111111111300000000000000000031111               
            11111111202111111111          101           11111111202111111111           
                    101                   101                   101
                    101                   101                   101
                    101                   101                   101
                 111202111                101                111202111   
                13000000031               101               13000000031   
                 111202111                101                111202111   
                    101                   101                   101
                    101                   101                   101
                    101                   101                   101
                    10311111111111111111112021111111111111111111301                   
                    10000000000000000000000000000000000000000000001                   
                     111111111111111111111101111111111111111111111
                                          101
                                          101
                                          101
                                          101
                                         12021
                                        1000001
                                         11011
                                          101
                                           1